8 7
1 4
3 6
#######
#....##
#....##
#......
#....##
#.....#
###...#
#######
1
2 4 03000000